阿空	 a kong
阿燐	 a lin
艾丽	 ai li
爱丽丝	 ai li si
爱丽丝的魔法书	 ai li si de mo fa shu
爱丽丝玛格特洛依德	 ai li si ma ge te luo yi de
爱丽丝梦游仙境	 ai li si meng you xian jing
爱莲	 ai lian
爱塔妮缇拉尔瓦	 ai ta ni ti la er wa
奥莲姬	 ao lian ji
八百万之神	 ba bai wan zhi shen
八坂神奈子	 ba ban shen nai zi
八分咲	 ba fen xiao
八桥	 ba qiao
八意永琳	 ba yi yong lin
八云蓝	 ba yun lan
八云紫	 ba yun zi
百鬼夜行	 bai gui ye xing
白鹭风茗	 bai lu feng ming
稗田阿求	 bai tian a qiu
百万鬼夜行	 bai wan gui ye xing
百药枡	 bai yao sheng
白玉楼	 bai yu lou
半白泽	 ban bai ze
坂田合欢乃	 ban tian he huan nai
抱头蹲防	 bao tou dun fang
本居小铃	 ben ju xiao ling
彼岸	 bi an
彼岸归航	 bi an gui hang
比那名居天子	 bi na ming ju tian zi
弁弁	 bian bian
博丽	 bo li
博丽大结界	 bo li da jie jie
博丽结界	 bo li jie jie
博丽灵梦	 bo li ling meng
博丽神社	 bo li shen she
博丽神社例大祭	 bo li shen she li da ji
布都	 bu dou
布加勒斯特的人偶师	 bu jia le si te de ren ou shi
不可思议之国的爱丽丝	 bu ke si yi zhi guo de ai li si
不死之烟飘上月球	 bu si zhi yan piao shang yue qiu
擦弹	 ca dan
残机	 can ji
车万	 che wan
赤蛮奇	 chi man qi
重生	 chong sheng
船幽灵	 chuan you ling
纯狐	 chun hu
纯妈	 chun ma
纯情活泼的小姑娘	 chun qing huo po de xiao gu niang
茨歌仙	 ci ge xian
茨木华扇	 ci mu hua shan
萃梦想	 cui meng xiang
萃香	 cui xiang
村纱水蜜	 cun sha shui mi
大蛤蟆之池	 da ha ma zhi chi
大酱	 da jiang
大结界	 da jie jie
大妖精	 da yao jing
大玉	 da yu
弹幕	 dan mu
弹幕邪天鬼	 dan mu xie tian gui
弹幕战	 dan mu zhan
道中	 dao zhong
得点	 de dian
地底通路	 di di tong lu
敌机	 di ji
地灵殿	 di ling dian
地狱鸦	 di yu ya
掉残	 diao can
吊瓶妖	 diao ping yao
凋叶棕	 diao ye zong
丁礼田舞	 ding li tian wu
东方	 dong fang
东方蝉时歌	 dong fang chan shi ge
东方茨歌仙	 dong fang ci ge xian
东方萃梦想	 dong fang cui meng xiang
东方大往生	 dong fang da wang sheng
东方大战争	 dong fang da zhan zheng
东方地灵殿	 dong fang di ling dian
东方绯想天	 dong fang fei xiang tian
东方非想天则	 dong fang fei xiang tian ze
东方封魔录	 dong fang feng mo lu
东方风神录	 dong fang feng shen lu
东方绀珠传	 dong fang gan zhu chuan
东方怪绮谈	 dong fang guai qi tan
东方鬼形兽	 dong fang gui xing shou
东方红楼梦	 dong fang hong lou meng
东方红魔乡	 dong fang hong mo xiang
东方华烂漫	 dong fang hua lan man
东方花映冢	 dong fang hua ying zhong
东方幻想乡	 dong fang huan xiang xiang
东方辉针城	 dong fang hui zhen cheng
东方铃奈庵	 dong fang ling nai an
东方灵异传	 dong fang ling yi chuan
东方梦灵梦	 dong fang meng ling meng
东方梦时空	 dong fang meng shi kong
东方儚月抄	 dong fang meng yue chao
东方凭依华	 dong fang ping yi hua
东方清泉飨	 dong fang qing quan xiang
东方求闻口授	 dong fang qiu wen kou shou
东方求闻史纪	 dong fang qiu wen shi ji
东方三月精	 dong fang san yue jing
东方神灵庙	 dong fang shen ling miao
东方深秘录	 dong fang shen mi lu
东方四季呗	 dong fang si ji bei
东方天空璋	 dong fang tian kong zhang
东方天上花	 dong fang tian shang hua
东方童楼遥	 dong fang tong lou yao
东方外来韦编	 dong fang wai lai wei bian
东方文花帖	 dong fang wen hua tie
东方香霖堂	 dong fang xiang lin tang
东方心绮楼	 dong fang xin qi lou
东方星莲船	 dong fang xing lian chuan
东方妖妖梦	 dong fang yao yao meng
东方萤灯筏	 dong fang ying deng fa
东方樱蝶梦	 dong fang ying die meng
东方樱神月	 dong fang ying shen yue
东方永夜抄	 dong fang yong ye chao
东方游剧天	 dong fang you ju tian
东方紫香花	 dong fang zi xiang hua
东风谷早苗	 dong feng gu zao miao
多多良小伞	 duo duo liang xiao san
哆来咪	 duo lai mi
哆来咪苏伊特	 duo lai mi su yi te
二次创作	 er ci chuang zuo
二设	 er she
二岩猯藏	 er yan tuan cang
尔子田里乃	 er zi tian li nai
法界	 fa jie
反魂蝶	 fan hun die
芳香	 fang xiang
非符	 fei fu
非想天	 fei xiang tian
丰聪耳神子	 feng cong er shen zi
风见幽香	 feng jian you xiang
疯帽子茶会	 feng mao zi cha hui
封魔录	 feng mo lu
风神录	 feng shen lu
封兽鵺	 feng shou ye
风之暗穴	 feng zhi an xue
符卡	 fu ka
符卡规则	 fu ka gui ze
芙兰	 fu lan
芙兰朵露	 fu lan duo lu
芙兰朵露斯卡雷特	 fu lan duo lu si ka lei te
付丧神	 fu sang shen
绀珠传	 gan zhu chuan
高丽野阿吽	 gao li ye a hong
宫古芳香	 gong gu fang xiang
固定弹	 gu ding dan
鼓哥	 gu ge
鼓姐	 gu jie
古明地觉	 gu ming di jue
古明地恋	 gu ming di lian
怪绮谈	 guai qi tan
广有射怪鸟事	 guang you she guai niao shi
鬼人正邪	 gui ren zheng xie
哈德曼的妖怪少女	 ha de man de yao guai shao nv
河城荷取	 he cheng he qu
赫卡	 he ka
赫卡姐	 he ka jie
赫卡提亚	 he ka ti ya
赫卡提亚拉碧斯拉祖利	 he ka ti ya la bi si la zu li
荷取	 he qu
核融炉	 he rong lu
河童	 he tong
红楼	 hong lou
红美铃	 hong mei ling
红魔馆	 hong mo guan
红魔乡	 hong mo xiang
胡桃	 hu tao
冴月麟	 hu yue lin
椛椛	 hua hua
花开夜	 hua kai ye
华扇邸	 hua shan di
花映冢	 hua ying zhong
坏苹果	 huai ping guo
幻梦缘起	 huan meng yuan qi
幻视之夜	 huan shi zhi ye
幻想万华镜	 huan xiang wan hua jing
幻想夏乡	 huan xiang xia xiang
幻想乡	 huan xiang xiang
幻想乡空闪姬	 huan xiang xiang kong shan ji
幻想乡空战姬	 huan xiang xiang kong zhan ji
幻想乡少女大战	 huan xiang xiang shao nv da zhan
幻想乡玩家	 huan xiang xiang wan jia
幻想跃迁实验室	 huan xiang yue qian shi yan shi
幻缘团	 huan yuan tuan
幻月	 huan yue
幻跃团	 huan yue tuan
辉夜	 hui ye
慧音	 hui yin
辉针城	 hui zhen cheng
魂魄妖忌	 hun po yao ji
魂魄妖梦	 hun po yao meng
火车	 huo che
霍青娥	 huo qing e
火焰猫燐	 huo yan mao lin
姬海棠果	 ji hai tang guo
姬海棠极	 ji hai tang ji
姬海棠羽立	 ji hai tang yu li
键山雏	 jian shan chu
间歇泉	 jian xie quan
奖残	 jiang can
奖分	 jiang fen
结界	 jie jie
禁忌的魔法	 jin ji de mo fa
矜羯罗	 jin jie luo
今泉影狼	 jin quan ying lang
今昔幻想乡	 jin xi huan xiang xiang
堇子	 jin zi
京都幻想剧团	 jing du huan xiang ju tuan
静叶	 jing ye
旧地狱遗址	 jiu di yu yi zhi
旧都	 jiu du
九十九八桥	 jiu shi jiu ba qiao
九十九弁弁	 jiu shi jiu bian bian
九天瀑布	 jiu tian pu bu
菊理	 ju li
决死符	 jue si fu
卡娜安娜贝拉尔	 ka na an na bei la er
可悲的人偶	 ke bei de ren ou
克劳恩	 ke lao en
克劳恩皮丝	 ke lao en pi si
堀川雷鼓	 ku chuan lei gu
狂气之瞳	 kuang qi zhi tong
蓝妈	 lan ma
狼女	 lang nv
蕾蒂	 lei di
蕾蒂霍瓦特洛克	 lei di huo wa te luo ke
蕾拉	 lei la
蕾拉普莉兹姆利巴	 lei la pu li zi mu li ba
蕾米	 lei mi
蕾米莉亚	 lei mi li ya
蕾米莉亚斯卡雷特	 lei mi li ya si ka lei te
例大祭	 li da ji
莉格露	 li ge lu
莉格露奈特巴格	 li ge lu nai te ba ge
莉莉	 li li
莉莉白	 li li bai
莉莉黑	 li li hei
莉莉霍瓦特	 li li huo wa te
莉莉卡	 li li ka
莉莉卡普莉兹姆利巴	 li li ka pu li zi mu li ba
里香	 li xiang
恋恋	 lian lian
莲妈	 lian ma
莲子	 lian zi
铃瑚	 ling hu
灵力	 ling li
灵梦	 ling meng
铃奈庵	 ling nai an
令人怀念的东方之血	 ling ren huai nian de dong fang zhi xue
灵乌路空	 ling wu lu kong
铃仙	 ling xian
铃仙二号	 ling xian er hao
铃仙优昙华院因幡	 ling xian you tan hua yuan yin fan
灵异传	 ling yi chuan
留琴	 liu qin
六十年目的东方裁判	 liu shi nian mu di dong fang cai pan
辘轳首	 lu lu shou
露米娅	 lu mi ya
露娜	 lu na
露娜切露德	 lu na qie lu de
露娜萨	 lu na sa
露娜萨普莉兹姆利巴	 lu na sa pu li zi mu li ba
露易兹	 lu yi zi
洛天依	 luo tian yi
绿眼的嫉妒	 lv yan de ji du
玛艾露贝莉赫恩	 ma ai lu bei li he en
玛格特罗依德邸	 ma ge te luo yi de di
玛露奇	 ma lu qi
满福神社	 man fu shen she
梅蒂欣梅兰可莉	 mei di xin mei lan ke li
美国酱	 mei guo jiang
妹红	 mei hong
梅莉	 mei li
美铃	 mei ling
梅露兰	 mei lu lan
梅露兰普莉兹姆利巴	 mei lu lan pu li zi mu li ba
魅魔	 mei mo
梦殿大祀庙	 meng dian da si miao
梦时空	 meng shi kong
梦消失	 meng xiao shi
梦月	 meng yue
儚月抄	 meng yue chao
梦子	 meng zi
秘封噩梦日记	 mi feng e meng ri ji
秘封活动记录	 mi feng huo dong ji lu
秘封俱乐部异界摄影记录	 mi feng ju le bu yi jie she ying ji lu
米国酱	 mi guo jiang
咪咪号	 mi mi hao
秘神摩多罗	 mi shen mo duo luo
米斯蒂娅	 mi si di ya
米斯蒂娅萝蕾拉	 mi si di ya luo lei la
迷途之家	 mi tu zhi jia
迷途竹林	 mi tu zhu lin
面灵气	 mian ling qi
绵月丰姬	 mian yue feng ji
绵月依姬	 mian yue yi ji
冥界	 ming jie
命莲	 ming lian
命莲寺	 ming lian si
明罗	 ming luo
明治十七年的上海爱丽丝	 ming zhi shi qi nian de shang hai ai li si
摩多罗隐岐奈	 mo duo luo yin qi nai
魔法森林	 mo fa sen lin
魔法使	 mo fa shi
魔理沙	 mo li sha
魔理沙的弹幕回忆	 mo li sha de dan mu hui yi
摩西的奇迹	 mo xi de qi ji
娜兹玲	 na zi ling
牛崎润美	 niu qi run mei
帕露西	 pa lu xi
帕秋莉	 pa qiu li
帕秋莉诺蕾姬	 pa qiu li nuo lei ji
判定点	 pan ding dian
蓬莱人	 peng lai ren
蓬莱山辉夜	 peng lai shan hui ye
凭依华	 ping yi hua
凭坐在梦与现实之间	 ping zuo zai meng yu xian shi zhi jian
琪露诺	 qi lu nuo
琪斯美	 qi si mei
千年幻想乡	 qian nian huan xiang xiang
桥姬	 qiao ji
秦河胜	 qin he sheng
秦心	 qin xin
青娥	 qing e
清兰	 qing lan
青蛙子	 qing wa zi
秋静叶	 qiu jing ye
秋穰子	 qiu rang zi
求闻口授	 qiu wen kou shou
求闻史纪	 qiu wen shi ji
犬走椛	 quan zou hua
穰子	 rang zi
人间之里	 ren jian zhi li
人形裁判	 ren xing cai pan
人形使	 ren xing shi
人鱼	 ren yu
戎璎花	 rong ying hua
入道	 ru dao
乳町	 ru ding
若鹭姬	 ruo lu ji
萨拉	 sa la
萨丽艾尔	 sa li ai er
三分咲	 san fen xiao
三途川	 san tu chuan
伞妖	 san yao
三月精	 san yue jing
桑尼	 sang ni
桑尼米尔克	 sang ni mi er ke
骚灵	 sao ling
森近霖之助	 sen jin lin zhi zhu
山彦	 shan yan
上白泽慧音	 shang bai ze hui yin
少名针妙丸	 shao ming zhen miao wan
少女幻葬	 shao nv huan zang
少女觉的第三只眼	 shao nv jue de di san zhi yan
少女绮想曲	 shao nv qi xiang qu
射命丸文	 she ming wan wen
神话幻想	 shen hua huan xiang
神灵	 shen ling
神灵庙	 shen ling miao
神妈	 shen ma
深秘录	 shen mi lu
神奈子	 shen nai zi
神绮	 shen qi
神玉	 shen yu
神子	 shen zi
圣白莲	 sheng bai lian
圣莲船	 sheng lian chuan
生死之境	 sheng si zhi jing
十六夜	 shi liu ye
十六夜咲夜	 shi liu ye xiao ye
矢田寺成美	 shi tian si cheng mei
兽道	 shou dao
兽人	 shou ren
守矢神社	 shou shi shen she
水桥帕露西	 shui qiao pa lu xi
四重存在	 si chong cun zai
四季大人	 si ji da ren
四季映姬	 si ji ying ji
四季映姬亚玛萨那度	 si ji ying ji ya ma sa na du
斯卡雷特	 si ka lei te
死灵	 si ling
死神	 si shen
斯塔	 si ta
斯塔萨菲娅	 si ta sa fei ya
死亡幻想曲	 si wang huan xiang qu
寺子屋	 si zi wu
苏格拉底	 su ge la di
苏我屠自古	 su wo tu zi gu
随机弹	 sui ji dan
砕月	 sui yue
碎月	 sui yue
太阳花田	 tai yang hua tian
探女	 tan nv
藤原妹红	 teng yuan mei hong
天狗	 tian gou
天空璋	 tian kong zhang
天人	 tian ren
天邪鬼	 tian xie gui
天子	 tian zi
庭渡久侘歌	 ting du jiu cha ge
同人	 tong ren
土蜘蛛	 tu zhi zhu
土著信仰	 tu zhu xin yang
屠自古	 tu zi gu
外界	 wai jie
外来人	 wai lai ren
外来韦编	 wai lai wei bian
亡灵	 wang ling
为逝去公主所奏的七重奏	 wei shi qu gong zhu suo zou de qi chong zou
文花帖	 wen hua tie
文文	 wen wen
物部布都	 wu bu bu dou
五分咲	 wu fen xiao
无何有之乡	 wu he you zhi xiang
无名之丘	 wu ming zhi qiu
雾雨	 wu yu
雾雨魔理沙	 wu yu mo li sha
无缘冢	 wu yuan zhong
雾之湖	 wu zhi hu
稀神探女	 xi shen tan nv
西行寺幽幽子	 xi xing si you you zi
吸血鬼	 xi xue gui
献给逝去公主的七重奏	 xian gei shi qu gong zhu de qi chong zou
仙界	 xian jie
仙人	 xian ren
现世的秘术师	 xian shi de mi shu shi
香霖堂	 xiang lin tang
乡长	 xiang zhang
响子	 xiang zi
小町	 xiao ding
小恶魔	 xiao e mo
小米弹	 xiao mi dan
小人族	 xiao ren zu
小伞	 xiao san
小桶	 xiao tong
小兔姬	 xiao tu ji
小碗	 xiao wan
小五	 xiao wu
小小青蛙不输风雨	 xiao xiao qing wa bu shu feng yu
咲夜	 xiao ye
小野冢小町	 xiao ye zhong xiao ding
泄矢诹访子	 xie shi zou fang zi
心酱	 xin jiang
心绮楼	 xin qi lou
信仰是为了虚幻之人	 xin yang shi wei le xu huan zhi ren
星莲船	 xing lian chuan
星条旗的小丑	 xing tiao qi de xiao chou
星熊杯	 xing xiong bei
星熊勇仪	 xing xiong yong yi
星之器	 xing zhi qi
续关	 xu guan
玄武之泽	 xuan wu zhi ze
玄爷	 xuan ye
玄云海	 xuan yun hai
阎魔	 yan mo
妖虫	 yao chong
妖怪狸	 yao guai li
妖怪鼠	 yao guai shu
妖怪之山	 yao guai zhi shan
妖精	 yao jing
妖精大战争	 yao jing da zhan zheng
妖梦	 yao meng
妖兽	 yao shou
妖兔	 yao tu
妖妖跋扈	 yao yao ba hu
妖妖梦	 yao yao meng
鵺酱	 ye jiang
夜雀	 ye que
异变	 yi bian
伊吹萃香	 yi chui cui xiang
伊吹瓢	 yi chui piao
一分咲	 yi fen xiao
衣玖	 yi jiu
依莉斯	 yi li si
一轮	 yi lun
一设	 yi she
依神女苑	 yi shen nv yuan
依神紫苑	 yi shen zi yuan
易者	 yi zhe
因幡帝	 yin fan di
隐匿的四季	 yin ni de si ji
寅丸星	 yin wan xing
樱花樱花	 ying hua ying hua
影狼	 ying lang
永动之龛	 yong dong zhi kan
永江衣玖	 yong jiang yi jiu
永琳	 yong lin
永夜抄	 yong ye chao
勇仪	 yong yi
永远的春梦	 yong yuan de chun meng
永远的满月	 yong yuan de man yue
永远亭	 yong yuan ting
幽闭星光	 you bi xing guang
有顶天	 you ding tian
幽谷响子	 you gu xiang zi
幽幻魔眼	 you huan mo yan
幽灵	 you ling
幽冥结界	 you ming jie jie
幽香	 you xiang
幽雅的绽放墨染之樱	 you ya de zhan fang mo ran zhi ying
幽幽子	 you you zi
御伽之国的鬼岛	 yu jia zhi guo de gui dao
宇佐见堇子	 yu zuo jian jin zi
宇佐见堇子的魔法书	 yu zuo jian jin zi de mo fa shu
宇佐见莲子	 yu zuo jian lian zi
乐器妖怪	 yue qi yao guai
月人	 yue ren
月时计	 yue shi ji
月兔	 yue tu
月之都	 yue zhi dou
云居一轮	 yun ju yi lun
云山	 yun shan
再思之道	 zai si zhi dao
早苗	 zao miao
长相酷似周杰伦的村民	 zhang xiang ku si zhou jie lun de cun min
长者	 zhang zhe
针妙丸	 zhen miao wan
正邪	 zheng xie
中弹	 zhong dan
终符	 zhong fu
众神眷恋的幻想乡	 zhong shen juan lian de huan xiang xiang
朱鹭子	 zhu lu zi
竹取飞翔	 zhu qu fei xiang
转转	 zhuan zhuan
自机	 zi ji
自机狙	 zi ji ju
紫老太	 zi lao tai
紫妈	 zi ma
紫妹	 zi mei
紫奶奶	 zi nai nai
紫婆婆	 zi po po
紫香花	 zi xiang hua
诹访湖	 zou fang hu
诹访子	 zou fang zi
